,predictionType,utilDif,reward,negativeReward,numOfUpdates,lostUtil,wrongDecisions,correctDecisions,decisionShouldHaveDid,decisionShouldHaveDidNot,decisionNotHaveDid,decisionNotHaveDidNot
0,arima_predictions_server_1_tactic_1_sampleRate_0.csv,1107701.4029677464,21184324.90564829,294.8215889831815,1933,2834.099589847015,33,2571,1911,11,22,660
1,arima_predictions_server_1_tactic_1_sampleRate_5.csv,81166.40257959571,1565341.9283866028,0.0,520,0.0,0,520,520,0,0,0
2,arima_predictions_server_1_tactic_1_sampleRate_20.csv,92015.48444325145,1645215.5248907262,0.0,130,0.0,0,130,130,0,0,0
3,arima_predictions_server_1_tactic_1_sampleRate_10.csv,86283.90336167418,1624510.854423833,0.0,260,0.0,0,260,260,0,0,0
4,arima_predictions_server_3_tactic_1_sampleRate_0.csv,2901642.327408376,17112092.555517834,7963.474063229544,1954,21928.045896347066,158,2446,1869,73,85,577
5,arima_predictions_server_3_tactic_1_sampleRate_5.csv,381469.6329202603,1758767.8079567302,0.0,520,0.0,0,520,520,0,0,0
6,arima_predictions_server_3_tactic_1_sampleRate_10.csv,445907.2042154864,1826484.4590752595,0.0,260,0.0,0,260,260,0,0,0
7,arima_predictions_server_3_tactic_1_sampleRate_20.csv,444298.2700098355,1860551.2436178005,0.0,130,0.0,0,130,130,0,0,0
8,arima_predictions_server_2_tactic_1_sampleRate_10.csv,233484.15540408785,2334130.520015933,0.0,260,0.0,0,260,260,0,0,0
9,arima_predictions_server_2_tactic_1_sampleRate_5.csv,232559.05465900915,2267597.9763132758,0.0,520,0.0,0,520,520,0,0,0
10,arima_predictions_server_2_tactic_1_sampleRate_0.csv,2654934.9204055257,24991432.852573518,825.3278158948823,2083,5672.885893476176,43,2561,2061,21,22,500
11,arima_predictions_server_2_tactic_1_sampleRate_20.csv,242449.2987547754,2371457.3282350367,0.0,130,0.0,0,130,130,0,0,0
12,mlp_predictions_server_1_tactic_1_sampleRate_10.csv,68376.96257708402,1616413.1082691483,0.0,259,0.0,0,259,259,0,0,0
13,mlp_predictions_server_1_tactic_1_sampleRate_20.csv,83378.72499625111,1630427.45433604,0.0,129,0.0,0,129,129,0,0,0
14,mlp_predictions_server_1_tactic_1_sampleRate_0.csv,678556.4539631465,21188890.44433003,273.52627425868366,1914,5443.409354671941,30,2573,1905,21,9,668
15,mlp_predictions_server_1_tactic_1_sampleRate_0_no_ping.csv,917563.6561790375,21183956.836943943,327.6964729330049,1933,2345.888076035156,30,2573,1912,9,21,661
16,mlp_predictions_server_1_tactic_1_sampleRate_5.csv,72791.79199473822,1561690.9235249714,0.0,519,0.0,0,519,519,0,0,0
17,mlp_predictions_server_3_tactic_1_sampleRate_20.csv,399708.9163171334,1844180.406292604,0.0,129,0.0,0,129,129,0,0,0
18,mlp_predictions_server_3_tactic_1_sampleRate_10.csv,509293.4735056615,1818780.5524558804,0.0,259,0.0,0,259,259,0,0,0
19,mlp_predictions_server_3_tactic_1_sampleRate_0.csv,3425691.1057115467,17101253.152133185,9398.684739957584,1957,23602.98591291717,149,2454,1879,71,78,575
20,mlp_predictions_server_3_tactic_1_sampleRate_5.csv,383059.964853906,1755096.1754813339,0.0,519,0.0,0,519,519,0,0,0
21,mlp_predictions_server_3_tactic_1_sampleRate_0_no_ping.csv,3377140.011581892,17098389.144006576,9960.407744986773,1966,23802.159198979993,157,2446,1880,71,86,566
22,lstm_predictions_server_1_tactic_1_sampleRate_5.csv,134511.8257921548,1561690.9235249714,0.0,519,0.0,0,519,519,0,0,0
23,lstm_predictions_server_1_tactic_1_sampleRate_0.csv,1165985.8367650053,21194252.70120669,573.394330990435,1893,11294.880436991729,48,2555,1888,43,5,667
24,lstm_predictions_server_1_tactic_1_sampleRate_20.csv,77934.07802406291,1630427.45433604,0.0,129,0.0,0,129,129,0,0,0
25,lstm_predictions_server_1_tactic_1_sampleRate_0_no_ping.csv,746285.9541885969,21186544.189241678,244.91615450896145,1923,3588.7376615468593,28,2575,1909,14,14,666
26,lstm_predictions_server_1_tactic_1_sampleRate_10.csv,73991.75432615768,1616413.1082691483,0.0,259,0.0,0,259,259,0,0,0
27,lstm_predictions_server_3_tactic_1_sampleRate_10.csv,477972.99349851033,1818780.5524558804,0.0,259,0.0,0,259,259,0,0,0
28,lstm_predictions_server_3_tactic_1_sampleRate_5.csv,434513.6253742026,1755096.1754813339,0.0,519,0.0,0,519,519,0,0,0
29,lstm_predictions_server_3_tactic_1_sampleRate_0.csv,3163480.847646674,17111912.12465214,12315.08535575625,1904,41538.64515455906,189,2414,1844,129,60,570
30,lstm_predictions_server_3_tactic_1_sampleRate_20.csv,498628.0972210184,1844180.406292604,0.0,129,0.0,0,129,129,0,0,0
31,lstm_predictions_server_3_tactic_1_sampleRate_0_no_ping.csv,3384781.7258450547,17100537.938946743,9695.812002554609,1958,24841.53232930913,156,2447,1877,75,81,570
32,lstm_predictions_server_2_tactic_1_sampleRate_10.csv,248476.04705790567,2325838.018826228,0.0,259,0.0,0,259,259,0,0,0
33,lstm_predictions_server_2_tactic_1_sampleRate_20.csv,225539.8748093087,2351894.0231500785,0.0,129,0.0,0,129,129,0,0,0
34,lstm_predictions_server_2_tactic_1_sampleRate_0.csv,3625571.6907175938,25003829.971271735,1484.8686155009823,2035,15953.976620296107,61,2542,2032,58,3,510
35,lstm_predictions_server_2_tactic_1_sampleRate_5.csv,390346.1611795337,2264430.9758373955,0.0,519,0.0,0,519,519,0,0,0
36,lstm_predictions_server_2_tactic_1_sampleRate_0_no_ping.csv,3489198.266627691,24991097.597777277,1155.5588427492644,2080,7417.595231576645,53,2550,2054,27,26,496
37,ernn_predictions_server__server_1_tactic_1_test_weekdayOneHotsample_rate_0_predictions_noping.csv,3203344.4678426757,21186453.883021895,8765.594924948738,1926,23253.714960979803,130,2473,1858,62,68,615
38,ernn_predictions_server__server_1_tactic_1_test_weekdayOneHotsample_rate_5_predictions.csv,2238582.55643152,1561691.171235451,0.0,519,0.0,0,519,519,0,0,0
39,ernn_predictions_server__server_1_tactic_1_test_weekdayOneHotsample_rate_10_predictions.csv,2543483.6732427287,1617241.819511306,22710.860975646283,257,23210.860975646283,2,257,257,2,0,0
40,ernn_predictions_server__server_1_tactic_1_test_weekdayOneHotsample_rate_5_predictions_noping.csv,221150.02771248185,1561691.171235451,0.0,519,0.0,0,519,519,0,0,0
41,ernn_predictions_server__server_1_tactic_1_test_weekdayOneHotsample_rate_20_predictions_noping.csv,156237.1149180057,1630551.9410954558,11943.054828477807,128,12193.054828477807,1,128,128,1,0,0
42,ernn_predictions_server__server_1_tactic_1_test_weekdayOneHotsample_rate_0_predictions.csv,1882098.8046603617,21197351.164678168,646.7885170872578,1882,15642.65837627948,61,2542,1881,60,1,661
43,ernn_predictions_server__server_1_tactic_1_test_weekdayOneHotsample_rate_20_predictions.csv,490788.14816893474,1630427.9207809034,0.0,129,0.0,0,129,129,0,0,0
44,ernn_predictions_server__server_1_tactic_1_test_weekdayOneHotsample_rate_10_predictions_noping.csv,21964747.931980994,1617186.2603992412,10490.103063134218,257,10990.103063134218,2,257,257,2,0,0
45,ernn_predictions_server__server_3_tactic_1_test_weekdayOneHotsample_rate_20_predictions_noping.csv,614844.3141749692,1844784.0142660555,11488.434963055417,128,11738.434963055417,1,128,128,1,0,0
46,ernn_predictions_server__server_3_tactic_1_test_weekdayOneHotsample_rate_0_predictions.csv,3539463.401972832,17096209.94173215,8346.77334063097,2032,6962.8377291787765,161,2442,1897,26,135,545
47,ernn_predictions_server__server_3_tactic_1_test_weekdayOneHotsample_rate_10_predictions.csv,593540.7299842247,1818780.6173436712,0.0,259,0.0,0,259,259,0,0,0
48,ernn_predictions_server__server_3_tactic_1_test_weekdayOneHotsample_rate_10_predictions_noping.csv,473543.5225147223,1818780.6173436712,0.0,259,0.0,0,259,259,0,0,0
49,ernn_predictions_server__server_3_tactic_1_test_weekdayOneHotsample_rate_20_predictions.csv,610852.7391902751,1844180.4220283427,0.0,129,0.0,0,129,129,0,0,0
50,ernn_predictions_server__server_3_tactic_1_test_weekdayOneHotsample_rate_0_predictions_noping.csv,9234656.315805236,17083261.931279767,22100.09259142959,2110,18376.296427848276,291,2312,1867,48,243,445
51,ernn_predictions_server__server_3_tactic_1_test_weekdayOneHotsample_rate_5_predictions_noping.csv,373697.19357962254,1755096.2591624712,0.0,519,0.0,0,519,519,0,0,0
52,ernn_predictions_server__server_3_tactic_1_test_weekdayOneHotsample_rate_5_predictions.csv,1168551.2435036665,1755096.2591624712,0.0,519,0.0,0,519,519,0,0,0
53,ernn_predictions_server__server_2_tactic_1_test_weekdayOneHotsample_rate_0_predictions_noping.csv,2398111.9735895097,25009734.162407827,13108.641822694768,2011,35329.973990545965,93,2510,2007,89,4,503
54,ernn_predictions_server__server_2_tactic_1_test_weekdayOneHotsample_rate_5_predictions_noping.csv,554299.2618523922,2264430.821858872,0.0,519,0.0,0,519,519,0,0,0
55,ernn_predictions_server__server_2_tactic_1_test_weekdayOneHotsample_rate_10_predictions.csv,1649264.8845028994,2327694.178288324,5331.66828844503,258,5581.66828844503,1,258,258,1,0,0
56,ernn_predictions_server__server_2_tactic_1_test_weekdayOneHotsample_rate_0_predictions.csv,6864427.561808692,25026828.553537507,7860.3126049590965,1943,50360.31260495909,170,2433,1943,170,0,490
57,ernn_predictions_server__server_2_tactic_1_test_weekdayOneHotsample_rate_5_predictions.csv,3271350.9278374123,2264430.821858872,0.0,519,0.0,0,519,519,0,0,0
58,ernn_predictions_server__server_2_tactic_1_test_weekdayOneHotsample_rate_20_predictions.csv,4767605.588222934,2349510.5921287,16354.326659819708,128,16604.326659819708,1,128,128,1,0,0
59,ernn_predictions_server__server_2_tactic_1_test_weekdayOneHotsample_rate_10_predictions_noping.csv,793343.572352573,2325837.813839487,0.0,259,0.0,0,259,259,0,0,0
60,ernn_predictions_server__server_2_tactic_1_test_weekdayOneHotsample_rate_20_predictions_noping.csv,703735.2521106454,2356450.8618041165,14321.77281491746,128,14571.77281491746,1,128,128,1,0,0
