,predictionType,utilDif,reward,negativeReward,numOfUpdates,lostUtil,wrongDecisions,correctDecisions,decisionShouldHaveDid,decisionShouldHaveDidNot,decisionNotHaveDid,decisionNotHaveDidNot
0,arima_predictions_server_1_tactic_1_sampleRate_0.csv,1143000.2803629353,20623876.15577209,2883.6941434539826,1043,30673.438600471018,54,2550,1018,29,25,1532
1,arima_predictions_server_1_tactic_1_sampleRate_5.csv,81420.76833275188,1183209.9424466325,162.11988721480202,512,1162.119887214802,1,519,512,1,0,7
2,arima_predictions_server_1_tactic_1_sampleRate_20.csv,92015.48444325145,1547715.5248907262,0.0,130,0.0,0,130,130,0,0,0
3,arima_predictions_server_1_tactic_1_sampleRate_10.csv,86283.90336167418,1429510.854423833,0.0,260,0.0,0,260,260,0,0,0
4,arima_predictions_server_3_tactic_1_sampleRate_0.csv,3050993.3906600615,16504890.1933527,61091.08166543218,1115,182833.5325327588,281,2323,980,146,135,1343
5,arima_predictions_server_3_tactic_1_sampleRate_5.csv,383156.45161388273,1376861.764847852,4343.43663858364,513,7080.539003085856,9,511,508,4,5,3
6,arima_predictions_server_3_tactic_1_sampleRate_10.csv,445907.2042154864,1631484.4590752602,0.0,260,0.0,0,260,260,0,0,0
7,arima_predictions_server_3_tactic_1_sampleRate_20.csv,444298.2700098355,1763051.2436178003,0.0,130,0.0,0,130,130,0,0,0
8,arima_predictions_server_2_tactic_1_sampleRate_10.csv,233484.15540408785,2139130.5200159317,0.0,260,0.0,0,260,260,0,0,0
9,arima_predictions_server_2_tactic_1_sampleRate_5.csv,232652.52988517034,1878623.205604958,0.0,519,0.0,0,520,519,0,0,1
10,arima_predictions_server_2_tactic_1_sampleRate_0.csv,2711900.468974269,24240501.796997756,10779.3352421507,1273,68700.34162831672,123,2481,1213,63,60,1268
11,arima_predictions_server_2_tactic_1_sampleRate_20.csv,242449.2987547754,2273957.328235036,0.0,130,0.0,0,130,130,0,0,0
12,mlp_predictions_server_1_tactic_1_sampleRate_10.csv,68376.96257708402,1422163.1082691485,0.0,259,0.0,0,259,259,0,0,0
13,mlp_predictions_server_1_tactic_1_sampleRate_20.csv,83378.72499625111,1533677.45433604,0.0,129,0.0,0,129,129,0,0,0
14,mlp_predictions_server_1_tactic_1_sampleRate_0.csv,707720.7992532739,20628183.169342373,1981.094874868119,1039,27290.319482698927,42,2561,1023,26,16,1538
15,mlp_predictions_server_1_tactic_1_sampleRate_0_no_ping.csv,956569.3520803457,20599039.721192062,3779.8363456639836,1066,22111.205356924198,74,2529,1013,21,53,1516
16,mlp_predictions_server_1_tactic_1_sampleRate_5.csv,73033.00117924754,1179307.7148841477,0.0,512,0.0,0,519,512,0,0,7
17,mlp_predictions_server_3_tactic_1_sampleRate_20.csv,399708.9163171334,1747430.4062926038,0.0,129,0.0,0,129,129,0,0,0
18,mlp_predictions_server_3_tactic_1_sampleRate_10.csv,509293.4735056615,1624530.5524558814,0.0,259,0.0,0,259,259,0,0,0
19,mlp_predictions_server_3_tactic_1_sampleRate_0.csv,3584682.724665098,16437461.63256558,62732.246283827415,1120,168546.91418227233,307,2296,951,138,169,1345
20,mlp_predictions_server_3_tactic_1_sampleRate_5.csv,383515.20752294915,1370056.4132646848,1262.897635497783,516,0.0,5,514,511,0,5,3
21,mlp_predictions_server_3_tactic_1_sampleRate_0_no_ping.csv,3537599.591983533,16426759.343596045,66397.65950448331,1126,176233.22533471708,329,2274,942,145,184,1332
22,lstm_predictions_server_1_tactic_1_sampleRate_5.csv,135158.60785191253,1182355.8056235162,110.67259137372059,509,3110.672591373721,3,516,509,3,0,7
23,lstm_predictions_server_1_tactic_1_sampleRate_0.csv,1225025.616346459,20654127.549072385,6822.182592275576,1013,103176.55975052588,106,2497,1004,97,9,1493
24,lstm_predictions_server_1_tactic_1_sampleRate_20.csv,77934.07802406291,1533677.45433604,0.0,129,0.0,0,129,129,0,0,0
25,lstm_predictions_server_1_tactic_1_sampleRate_0_no_ping.csv,782369.5509541266,20627884.508854017,3045.437807476387,1037,40977.12175076149,61,2542,1015,39,22,1527
26,lstm_predictions_server_1_tactic_1_sampleRate_10.csv,73991.75432615768,1422163.1082691485,0.0,259,0.0,0,259,259,0,0,0
27,lstm_predictions_server_3_tactic_1_sampleRate_10.csv,477972.99349851033,1624530.5524558814,0.0,259,0.0,0,259,259,0,0,0
28,lstm_predictions_server_3_tactic_1_sampleRate_5.csv,437736.63752535096,1370550.317688938,6076.962330718846,511,8889.326304431874,8,511,507,4,4,4
29,lstm_predictions_server_3_tactic_1_sampleRate_0.csv,3339729.0318179047,16493370.365201402,74860.39446661073,1050,300107.7751874752,351,2252,945,246,105,1307
30,lstm_predictions_server_3_tactic_1_sampleRate_20.csv,498628.0972210184,1747430.4062926038,0.0,129,0.0,0,129,129,0,0,0
31,lstm_predictions_server_3_tactic_1_sampleRate_0_no_ping.csv,3544682.7808371703,16432322.07177544,67900.1015969587,1120,191860.99610292396,332,2271,945,157,175,1326
32,lstm_predictions_server_2_tactic_1_sampleRate_10.csv,248476.04705790567,2131588.018826227,0.0,259,0.0,0,259,259,0,0,0
33,lstm_predictions_server_2_tactic_1_sampleRate_20.csv,225539.8748093087,2255144.023150078,0.0,129,0.0,0,129,129,0,0,0
34,lstm_predictions_server_2_tactic_1_sampleRate_0.csv,3715430.424548042,24323328.91224894,18388.93469901745,1188,192220.69105662717,177,2426,1185,174,3,1241
35,lstm_predictions_server_2_tactic_1_sampleRate_5.csv,390863.77089491184,1877363.9020398161,100.26107810942904,517,1100.261078109429,1,518,517,1,0,1
36,lstm_predictions_server_2_tactic_1_sampleRate_0_no_ping.csv,3558036.980283863,24247447.21720214,12893.360250490176,1252,100074.69753320754,130,2473,1212,90,40,1261
37,ernn_predictions_server__server_1_tactic_1_test_weekdayOneHotsample_rate_0_predictions_noping.csv,3363332.3661036324,20605890.451260608,62663.87948370965,1072,163846.42287503352,265,2338,918,111,154,1420
38,ernn_predictions_server__server_1_tactic_1_test_weekdayOneHotsample_rate_5_predictions.csv,2239551.722657392,1182619.2449498908,440.98844013729683,509,5284.989286912026,7,512,507,5,2,5
39,ernn_predictions_server__server_1_tactic_1_test_weekdayOneHotsample_rate_10_predictions.csv,2543483.6732427287,1424491.8195113062,21210.860975646283,257,23210.860975646283,2,257,257,2,0,0
40,ernn_predictions_server__server_1_tactic_1_test_weekdayOneHotsample_rate_5_predictions_noping.csv,221348.87515793132,1177447.2100936095,155.99915322527124,514,0.0,2,517,512,0,2,5
41,ernn_predictions_server__server_1_tactic_1_test_weekdayOneHotsample_rate_20_predictions_noping.csv,156237.1149180057,1534551.9410954558,11193.054828477807,128,12193.054828477807,1,128,128,1,0,0
42,ernn_predictions_server__server_1_tactic_1_test_weekdayOneHotsample_rate_0_predictions.csv,1937919.059720506,20663498.57542533,4999.4547589106405,1006,103529.20290242357,101,2502,1004,99,2,1498
43,ernn_predictions_server__server_1_tactic_1_test_weekdayOneHotsample_rate_20_predictions.csv,490788.14816893474,1533677.9207809034,0.0,129,0.0,0,129,129,0,0,0
44,ernn_predictions_server__server_1_tactic_1_test_weekdayOneHotsample_rate_10_predictions_noping.csv,21964747.931980994,1424436.2603992415,8990.103063134218,257,10990.103063134218,2,257,257,2,0,0
45,ernn_predictions_server__server_3_tactic_1_test_weekdayOneHotsample_rate_20_predictions_noping.csv,614844.3141749692,1748784.0142660555,10738.434963055417,128,11738.434963055417,1,128,128,1,0,0
46,ernn_predictions_server__server_3_tactic_1_test_weekdayOneHotsample_rate_0_predictions.csv,3662140.510243834,16433107.46999198,64342.96764314178,1218,56672.7813040604,298,2305,974,54,244,1331
47,ernn_predictions_server__server_3_tactic_1_test_weekdayOneHotsample_rate_10_predictions.csv,593540.7299842247,1624530.617343671,0.0,259,0.0,0,259,259,0,0,0
48,ernn_predictions_server__server_3_tactic_1_test_weekdayOneHotsample_rate_10_predictions_noping.csv,473543.5225147223,1624530.617343671,0.0,259,0.0,0,259,259,0,0,0
49,ernn_predictions_server__server_3_tactic_1_test_weekdayOneHotsample_rate_20_predictions.csv,610852.7391902751,1747430.4220283427,0.0,129,0.0,0,129,129,0,0,0
50,ernn_predictions_server__server_3_tactic_1_test_weekdayOneHotsample_rate_0_predictions_noping.csv,9476790.377155418,16379346.852975287,179554.8704381327,1340,147788.37056842213,569,2034,869,98,471,1165
51,ernn_predictions_server__server_3_tactic_1_test_weekdayOneHotsample_rate_5_predictions_noping.csv,373967.6681795484,1370056.4965128272,1262.894971630811,516,0.0,5,514,511,0,5,3
52,ernn_predictions_server__server_3_tactic_1_test_weekdayOneHotsample_rate_5_predictions.csv,1171230.1043507387,1376819.5163171224,3522.0599860112934,511,8053.97106214835,12,507,505,6,6,2
53,ernn_predictions_server__server_2_tactic_1_test_weekdayOneHotsample_rate_0_predictions_noping.csv,2580065.5168164987,24338534.217745606,103641.44239196299,1181,298263.7742709504,198,2405,1178,195,3,1227
54,ernn_predictions_server__server_2_tactic_1_test_weekdayOneHotsample_rate_5_predictions_noping.csv,555879.3427589155,1879247.368621723,732.7059783081315,515,3732.7059783081313,3,516,515,3,0,1
55,ernn_predictions_server__server_2_tactic_1_test_weekdayOneHotsample_rate_10_predictions.csv,1649264.8845028994,2134194.178288323,4581.66828844503,258,5581.66828844503,1,258,258,1,0,0
56,ernn_predictions_server__server_2_tactic_1_test_weekdayOneHotsample_rate_0_predictions.csv,7070004.621019349,24427710.297971204,55551.26552116989,1088,385551.26552116993,330,2273,1088,330,0,1185
57,ernn_predictions_server__server_2_tactic_1_test_weekdayOneHotsample_rate_5_predictions.csv,3273139.1858650665,1878377.7477794061,1256.430196554429,516,4152.3410036563,4,515,515,3,1,0
58,ernn_predictions_server__server_2_tactic_1_test_weekdayOneHotsample_rate_20_predictions.csv,4767605.588222934,2253510.5921287,15604.326659819708,128,16604.326659819708,1,128,128,1,0,0
59,ernn_predictions_server__server_2_tactic_1_test_weekdayOneHotsample_rate_10_predictions_noping.csv,793343.572352573,2131587.8138394854,0.0,259,0.0,0,259,259,0,0,0
60,ernn_predictions_server__server_2_tactic_1_test_weekdayOneHotsample_rate_20_predictions_noping.csv,703735.2521106454,2260450.8618041165,13571.77281491746,128,14571.77281491746,1,128,128,1,0,0
